############################
#++++++++++++##++++++++++++#
#+####+#####+##+#####+####+#
#%####+#####+##+#####+####%#
#+####+#####+##+#####+####+#
#++++++++++++++++++++++++++#
#+####+##+########+##+####+#
#+####+##+########+##+####+#
#++++++##++++##++++##++++++#
######+#####-##-#####+######
-----#+#####-##-#####+#-----
-----#+##----------##+#-----
-----#+##-###__###-##+#-----
######+##-##----##-##+######
------+---##----##---+------
######+##-########-##+######
-----#+##-########-##+#-----
-----#+##----------##+#-----
-----#+##-########-##+#-----
######+##-########-##+######
#++++++++++++##++++++++++++#
#+####+#####+##+#####+####+#
#+####+#####+##+#####+####+#
#%++##+++++++--+++++++##++%#
###+##+##+########+##+##+###
###+##+##+########+##+##+###
#++++++##++++##++++##++++++#
#+##########+##+##########+#
#+##########+##+##########+#
#++++++++++++++++++++++++++#
############################